type octile
height 128
width 128
map
TTTTTTTTTTTTTTTTTTTTTTTTTTTTTTTTTTTTTTTTTTTTTTTTTTTTTTTTTTTTTTTTTTTTTTTTTTTTTTTTTTTTTTTTTTTTTTTTTTTTTTTTTTTTTTTTTTTTTTTTTTTTTTTT
T..T...T...T...T.............................................................................................................T.T
TT...T...T...T...TTTTTTTTTTTTTTTTTTTTTTTTTTTTTTTTTTTTTTTTTTTTTTTT............................................................T.T
T..T...T...T...T.TTTTTTTTTTTTTTTTTTTTTTTTTTTTTTTTTTTTTTTTTTTTTTTT............................................................T.T
TT...T...T...T...............................................................................................................T.T
T..T...T...T...T.TTTTTTTTTTTTTTTTTTTTTTTTTTTTTTTTTTTTTTTTTTTTTTTT............................................................T.T
TT...T...T...T...TTTTTTTTTTTTTTTTTTTTTTTTTTTTTTTTTTTTTTTTTTTTTTTT............................................................T.T
T..T...T...T...T.TTTTTTTTTTTTTTTTTTTTTTTTTTTTTTTTTTTTTTTTTTTTTTTT............................................................T.T
TT...T...T...T...............................................................................................................T.T
T..T...T...T...T.TTTTTTTTTTTTTTTTTTTTTTTTTTTTTTTTTTTTTTTTTTTTTTTT............................................................T.T
TT...T...T...T...TTTTTTTTTTTTTTTTTTTTTTTTTTTTTTTTTTTTTTTTTTTTTTTT............................................................T.T
T..T...T...T...T.TTTTTTTTTTTTTTTTTTTTTTTTTTTTTTTTTTTTTTTTTTTTTTTT............................................................T.T
TT...T...T...T...............................................................................................................T.T
T..T...T...T...T.TTTTTTTTTTTTTTTTTTTTTTTTTTTTTTTTTTTTTTTTTTTTTTTT............................................................T.T
TT...T...T...T...TTTTTTTTTTTTTTTTTTTTTTTTTTTTTTTTTTTTTTTTTTTTTTTT............................................................T.T
T..T...T...T...T.TTTTTTTTTTTTTTTTTTTTTTTTTTTTTTTTTTTTTTTTTTTTTTTT............................................................T.T
TT...T...T...T...............................................................................................................T.T
T..T...T...T...T.TTTTTTTTTTTTTTTTTTTTTTTTTTTTTTTTTTTTTTTTTTTTTTTT............................................................T.T
TT...T...T...T...TTTTTTTTTTTTTTTTTTTTTTTTTTTTTTTTTTTTTTTTTTTTTTTT............................................................T.T
T..T...T...T...T.TTTTTTTTTTTTTTTTTTTTTTTTTTTTTTTTTTTTTTTTTTTTTTTT............................................................T.T
TT...T...T...T...............................................................................................................T.T
T..T...T...T...T.TTTTTTTTTTTTTTTTTTTTTTTTTTTTTTTTTTTTTTTTTTTTTTTT............................................................T.T
TT...T...T...T...TTTTTTTTTTTTTTTTTTTTTTTTTTTTTTTTTTTTTTTTTTTTTTTT............................................................T.T
T..T...T...T...T.TTTTTTTTTTTTTTTTTTTTTTTTTTTTTTTTTTTTTTTTTTTTTTTT............................................................T.T
TT...T...T...T...............................................................................................................T.T
T..T...T...T...T.TTTTTTTTTTTTTTTTTTTTTTTTTTTTTTTTTTTTTTTTTTTTTTTT............................................................T.T
TT...T...T...T...TTTTTTTTTTTTTTTTTTTTTTTTTTTTTTTTTTTTTTTTTTTTTTTT............................................................T.T
T..T...T...T...T.TTTTTTTTTTTTTTTTTTTTTTTTTTTTTTTTTTTTTTTTTTTTTTTT............................................................T.T
TT...T...T...T...............................................................................................................T.T
T..T...T...T...T.TTTTTTTTTTTTTTTTTTTTTTTTTTTTTTTTTTTTTTTTTTTTTTTT............................................................T.T
TT...T...T...T...TTTTTTTTTTTTTTTTTTTTTTTTTTTTTTTTTTTTTTTTTTTTTTTT............................................................T.T
T..T...T...T...T.TTTTTTTTTTTTTTTTTTTTTTTTTTTTTTTTTTTTTTTTTTTTTTTT............................................................T.T
TT...T...T...T...............................................................................................................T.T
T..T...T...T...T.TTTTTTTTTTTTTTTTTTTTTTTTTTTTTTTTTTTTTTTTTTTTTTTT............................................................T.T
TT...T...T...T...TTTTTTTTTTTTTTTTTTTTTTTTTTTTTTTTTTTTTTTTTTTTTTTT............................................................T.T
T..T...T...T...T.TTTTTTTTTTTTTTTTTTTTTTTTTTTTTTTTTTTTTTTTTTTTTTTT............................................................T.T
TT...T...T...T...............................................................................................................T.T
T..T...T...T...T.TTTTTTTTTTTTTTTTTTTTTTTTTTTTTTTTTTTTTTTTTTTTTTTT............................................................T.T
TT...T...T...T...TTTTTTTTTTTTTTTTTTTTTTTTTTTTTTTTTTTTTTTTTTTTTTTT............................................................T.T
T..T...T...T...T.TTTTTTTTTTTTTTTTTTTTTTTTTTTTTTTTTTTTTTTTTTTTTTTT............................................................T.T
TT...T...T...T...............................................................................................................T.T
T..T...T...T...T.TTTTTTTTTTTTTTTTTTTTTTTTTTTTTTTTTTTTTTTTTTTTTTTT............................................................T.T
TT...T...T...T...TTTTTTTTTTTTTTTTTTTTTTTTTTTTTTTTTTTTTTTTTTTTTTTT............................................................T.T
T..T...T...T...T.TTTTTTTTTTTTTTTTTTTTTTTTTTTTTTTTTTTTTTTTTTTTTTTT............................................................T.T
TT...T...T...T...............................................................................................................T.T
T..T...T...T...T.TTTTTTTTTTTTTTTTTTTTTTTTTTTTTTTTTTTTTTTTTTTTTTTT............................................................T.T
TT...T...T...T...TTTTTTTTTTTTTTTTTTTTTTTTTTTTTTTTTTTTTTTTTTTTTTTT............................................................T.T
T..T...T...T...T.TTTTTTTTTTTTTTTTTTTTTTTTTTTTTTTTTTTTTTTTTTTTTTTT............................................................T.T
TT...T...T...T...............................................................................................................T.T
T..T...T...T...T.TTTTTTTTTTTTTTTTTTTTTTTTTTTTTTTTTTTTTTTTTTTTTTTT............................................................T.T
TT...T...T...T...TTTTTTTTTTTTTTTTTTTTTTTTTTTTTTTTTTTTTTTTTTTTTTTT............................................................T.T
T..T...T...T...T.TTTTTTTTTTTTTTTTTTTTTTTTTTTTTTTTTTTTTTTTTTTTTTTT............................................................T.T
TT...T...T...T...............................................................................................................T.T
T..T...T...T...T.TTTTTTTTTTTTTTTTTTTTTTTTTTTTTTTTTTTTTTTTTTTTTTTT............................................................T.T
TT...T...T...T...TTTTTTTTTTTTTTTTTTTTTTTTTTTTTTTTTTTTTTTTTTTTTTTT............................................................T.T
T..T...T...T...T.TTTTTTTTTTTTTTTTTTTTTTTTTTTTTTTTTTTTTTTTTTTTTTTT............................................................T.T
TT...T...T...T...............................................................................................................T.T
T..T...T...T...T.TTTTTTTTTTTTTTTTTTTTTTTTTTTTTTTTTTTTTTTTTTTTTTTT............................................................T.T
TT...T...T...T...TTTTTTTTTTTTTTTTTTTTTTTTTTTTTTTTTTTTTTTTTTTTTTTT............................................................T.T
T..T...T...T...T.TTTTTTTTTTTTTTTTTTTTTTTTTTTTTTTTTTTTTTTTTTTTTTTT............................................................T.T
TT...T...T...T...............................................................................................................T.T
T..T...T...T...T.TTTTTTTTTTTTTTTTTTTTTTTTTTTTTTTTTTTTTTTTTTTTTTTT............................................................T.T
TT...T...T...T...TTTTTTTTTTTTTTTTTTTTTTTTTTTTTTTTTTTTTTTTTTTTTTTT............................................................T.T
T..T...T...T...T.TTTTTTTTTTTTTTTTTTTTTTTTTTTTTTTTTTTTTTTTTTTTTTTT............................................................T.T
TT...T...T...T...............................................................................................................T.T
T..T...T...T...T.TTTTTTTTTTTTTTTTTTTTTTTTTTTTTTTTTTTTTTTTTTTTTTTT............................................................T.T
TT...T...T...T...TTTTTTTTTTTTTTTTTTTTTTTTTTTTTTTTTTTTTTTTTTTTTTTT............................................................T.T
T..T...T...T...T.TTTTTTTTTTTTTTTTTTTTTTTTTTTTTTTTTTTTTTTTTTTTTTTT............................................................T.T
TT...T...T...T...............................................................................................................T.T
T..T...T...T...T.TTTTTTTTTTTTTTTTTTTTTTTTTTTTTTTTTTTTTTTTTTTTTTTT............................................................T.T
TT...T...T...T...TTTTTTTTTTTTTTTTTTTTTTTTTTTTTTTTTTTTTTTTTTTTTTTT............................................................T.T
T..T...T...T...T.TTTTTTTTTTTTTTTTTTTTTTTTTTTTTTTTTTTTTTTTTTTTTTTT............................................................T.T
TT...T...T...T...............................................................................................................T.T
T..T...T...T...T.TTTTTTTTTTTTTTTTTTTTTTTTTTTTTTTTTTTTTTTTTTTTTTTT............................................................T.T
TT...T...T...T...TTTTTTTTTTTTTTTTTTTTTTTTTTTTTTTTTTTTTTTTTTTTTTTT............................................................T.T
T..T...T...T...T.TTTTTTTTTTTTTTTTTTTTTTTTTTTTTTTTTTTTTTTTTTTTTTTT............................................................T.T
TT...T...T...T...............................................................................................................T.T
T..T...T...T...T.TTTTTTTTTTTTTTTTTTTTTTTTTTTTTTTTTTTTTTTTTTTTTTTT............................................................T.T
TT...T...T...T...TTTTTTTTTTTTTTTTTTTTTTTTTTTTTTTTTTTTTTTTTTTTTTTT............................................................T.T
T..T...T...T...T.TTTTTTTTTTTTTTTTTTTTTTTTTTTTTTTTTTTTTTTTTTTTTTTT............................................................T.T
TT...T...T...T...............................................................................................................T.T
T..T...T...T...T.TTTTTTTTTTTTTTTTTTTTTTTTTTTTTTTTTTTTTTTTTTTTTTTT............................................................T.T
TT...T...T...T...TTTTTTTTTTTTTTTTTTTTTTTTTTTTTTTTTTTTTTTTTTTTTTTT............................................................T.T
T..T...T...T...T.TTTTTTTTTTTTTTTTTTTTTTTTTTTTTTTTTTTTTTTTTTTTTTTT............................................................T.T
TT...T...T...T...............................................................................................................T.T
T..T...T...T...T.TTTTTTTTTTTTTTTTTTTTTTTTTTTTTTTTTTTTTTTTTTTTTTTT............................................................T.T
TT...T...T...T...TTTTTTTTTTTTTTTTTTTTTTTTTTTTTTTTTTTTTTTTTTTTTTTT............................................................T.T
T..T...T...T...T.TTTTTTTTTTTTTTTTTTTTTTTTTTTTTTTTTTTTTTTTTTTTTTTT............................................................T.T
TT...T...T...T...............................................................................................................T.T
T..T...T...T...T.TTTTTTTTTTTTTTTTTTTTTTTTTTTTTTTTTTTTTTTTTTTTTTTT............................................................T.T
TT...T...T...T...TTTTTTTTTTTTTTTTTTTTTTTTTTTTTTTTTTTTTTTTTTTTTTTT............................................................T.T
T..T...T...T...T.TTTTTTTTTTTTTTTTTTTTTTTTTTTTTTTTTTTTTTTTTTTTTTTT............................................................T.T
TT...T...T...T...............................................................................................................T.T
T..T...T...T...T.TTTTTTTTTTTTTTTTTTTTTTTTTTTTTTTTTTTTTTTTTTTTTTTT............................................................T.T
TT...T...T...T...TTTTTTTTTTTTTTTTTTTTTTTTTTTTTTTTTTTTTTTTTTTTTTTT............................................................T.T
T..T...T...T...T.TTTTTTTTTTTTTTTTTTTTTTTTTTTTTTTTTTTTTTTTTTTTTTTT............................................................T.T
TT...T...T...T...............................................................................................................T.T
T..T...T...T...T.TTTTTTTTTTTTTTTTTTTTTTTTTTTTTTTTTTTTTTTTTTTTTTTT............................................................T.T
TT...T...T...T...TTTTTTTTTTTTTTTTTTTTTTTTTTTTTTTTTTTTTTTTTTTTTTTT............................................................T.T
T..T...T...T...T.TTTTTTTTTTTTTTTTTTTTTTTTTTTTTTTTTTTTTTTTTTTTTTTT............................................................T.T
TT...T...T...T...............................................................................................................T.T
T..T...T...T...T.TTTTTTTTTTTTTTTTTTTTTTTTTTTTTTTTTTTTTTTTTTTTTTTT............................................................T.T
TT...T...T...T...TTTTTTTTTTTTTTTTTTTTTTTTTTTTTTTTTTTTTTTTTTTTTTTT............................................................T.T
T..T...T...T...T.TTTTTTTTTTTTTTTTTTTTTTTTTTTTTTTTTTTTTTTTTTTTTTTT............................................................T.T
TT...T...T...T...............................................................................................................T.T
T..T...T...T...T.TTTTTTTTTTTTTTTTTTTTTTTTTTTTTTTTTTTTTTTTTTTTTTTT............................................................T.T
TT...T...T...T...TTTTTTTTTTTTTTTTTTTTTTTTTTTTTTTTTTTTTTTTTTTTTTTT............................................................T.T
T..T...T...T...T.TTTTTTTTTTTTTTTTTTTTTTTTTTTTTTTTTTTTTTTTTTTTTTTT............................................................T.T
TT...T...T...T...............................................................................................................T.T
T..T...T...T...T.TTTTTTTTTTTTTTTTTTTTTTTTTTTTTTTTTTTTTTTTTTTTTTTT............................................................T.T
TT...T...T...T...TTTTTTTTTTTTTTTTTTTTTTTTTTTTTTTTTTTTTTTTTTTTTTTT............................................................T.T
T..T...T...T...T.TTTTTTTTTTTTTTTTTTTTTTTTTTTTTTTTTTTTTTTTTTTTTTTT............................................................T.T
TT...T...T...T...............................................................................................................T.T
T..T...T...T...T.TTTTTTTTTTTTTTTTTTTTTTTTTTTTTTTTTTTTTTTTTTTTTTTT............................................................T.T
TT...T...T...T...TTTTTTTTTTTTTTTTTTTTTTTTTTTTTTTTTTTTTTTTTTTTTTTT............................................................T.T
T..T...T...T...T.TTTTTTTTTTTTTTTTTTTTTTTTTTTTTTTTTTTTTTTTTTTTTTTT............................................................T.T
TT...T...T...T...............................................................................................................T.T
T..T...T...T...T.TTTTTTTTTTTTTTTTTTTTTTTTTTTTTTTTTTTTTTTTTTTTTTTT............................................................T.T
TT...T...T...T...TTTTTTTTTTTTTTTTTTTTTTTTTTTTTTTTTTTTTTTTTTTTTTTT............................................................T.T
T..T...T...T...T.TTTTTTTTTTTTTTTTTTTTTTTTTTTTTTTTTTTTTTTTTTTTTTTT............................................................T.T
TT...T...T...T...............................................................................................................T.T
T..T...T...T...T.TTTTTTTTTTTTTTTTTTTTTTTTTTTTTTTTTTTTTTTTTTTTTTTT............................................................T.T
TT...T...T...T...TTTTTTTTTTTTTTTTTTTTTTTTTTTTTTTTTTTTTTTTTTTTTTTT............................................................T.T
T..T...T...T...T.TTTTTTTTTTTTTTTTTTTTTTTTTTTTTTTTTTTTTTTTTTTTTTTT............................................................T.T
TT...T...T...T...............................................................................................................T.T
T..T...T...T...T.TTTTTTTTTTTTTTTTTTTTTTTTTTTTTTTTTTTTTTTTTTTTTTTT............................................................T.T
TT...T...T...T...TTTTTTTTTTTTTTTTTTTTTTTTTTTTTTTTTTTTTTTTTTTTTTTT............................................................T.T
TTTTTTTTTTTTTTTTTTTTTTTTTTTTTTTTTTTTTTTTTTTTTTTTTTTTTTTTTTTTTTTTTTTTTTTTTTTTTTTTTTTTTTTTTTTTTTTTTTTTTTTTTTTTTTTTTTTTTTTTTTTTTTT.
