type octile
height 32
width 32
map
TTTTTTTTTTTTTTTTTTTTTTTTTTTTTTTT
T............................T.T
T............................T.T
T............................T.T
T............................T.T
T............................T.T
T............................T.T
T............................T.T
T.T..........................T.T
T.T..........................T.T
T.T..........................T.T
T.T..........................T.T
T.T..........................T.T
T.T..........................T.T
T.T..........................T.T
T.T..........................T.T
T.T..........................T.T
T.T..........................T.T
T.T..........................T.T
T.T..........................T.T
T.T..........................T.T
T.T..........................T.T
T.T..........................T.T
T.T..........................T.T
T............................T.T
T............................T.T
T............................T.T
T............................T.T
T............................T.T
T............................T.T
T............................T.T
TTTTTTTTTTTTTTTTTTTTTTTTTTTTTTTT
