type octile
height 128
width 128
map
TTTTTTTTTTTTTTTTTTTTTTTTTTTTTTTTTTTTTTTTTTTTTTTTTTTTTTTTTTTTTTTTTTTTTTTTTTTTTTTTTTTTTTTTTTTTTTTTTTTTTTTTTTTTTTTTTTTTTTTTTTTTTTTT
T.T...T...T...T...T...T...T...T...T...T...T...T...T...T...T...T..............................................................T.T
T...T...T...T...T...T...T...T...T...T...T...T...T...T...T...T................................................................T.T
T.T...T...T...T...T...T...T...T...T...T...T...T...T...T...T...T..............................................................T.T
T...T...T...T...T...T...T...T...T...T...T...T...T...T...T...T................................................................T.T
T.T...T...T...T...T...T...T...T...T...T...T...T...T...T...T...T..............................................................T.T
T...T...T...T...T...T...T...T...T...T...T...T...T...T...T...T................................................................T.T
T.T...T...T...T...T...T...T...T...T...T...T...T...T...T...T...T..............................................................T.T
T...T...T...T...T...T...T...T...T...T...T...T...T...T...T...T................................................................T.T
T.T...T...T...T...T...T...T...T...T...T...T...T...T...T...T...T..............................................................T.T
T...T...T...T...T...T...T...T...T...T...T...T...T...T...T...T................................................................T.T
T.T...T...T...T...T...T...T...T...T...T...T...T...T...T...T...T..............................................................T.T
T...T...T...T...T...T...T...T...T...T...T...T...T...T...T...T................................................................T.T
T.T...T...T...T...T...T...T...T...T...T...T...T...T...T...T...T..............................................................T.T
T...T...T...T...T...T...T...T...T...T...T...T...T...T...T...T................................................................T.T
T.T...T...T...T...T...T...T...T...T...T...T...T...T...T...T...T..............................................................T.T
T...T...T...T...T...T...T...T...T...T...T...T...T...T...T...T................................................................T.T
T.T...T...T...T...T...T...T...T...T...T...T...T...T...T...T...T..............................................................T.T
T...T...T...T...T...T...T...T...T...T...T...T...T...T...T...T................................................................T.T
T.T...T...T...T...T...T...T...T...T...T...T...T...T...T...T...T..............................................................T.T
T...T...T...T...T...T...T...T...T...T...T...T...T...T...T...T................................................................T.T
T.T...T...T...T...T...T...T...T...T...T...T...T...T...T...T...T..............................................................T.T
T...T...T...T...T...T...T...T...T...T...T...T...T...T...T...T................................................................T.T
T.T...T...T...T...T...T...T...T...T...T...T...T...T...T...T...T..............................................................T.T
T...T...T...T...T...T...T...T...T...T...T...T...T...T...T...T................................................................T.T
T.T...T...T...T...T...T...T...T...T...T...T...T...T...T...T...T..............................................................T.T
T...T...T...T...T...T...T...T...T...T...T...T...T...T...T...T................................................................T.T
T.T...T...T...T...T...T...T...T...T...T...T...T...T...T...T...T..............................................................T.T
T...T...T...T...T...T...T...T...T...T...T...T...T...T...T...T................................................................T.T
T.T...T...T...T...T...T...T...T...T...T...T...T...T...T...T...T..............................................................T.T
T...T...T...T...T...T...T...T...T...T...T...T...T...T...T...T................................................................T.T
T.T...T...T...T...T...T...T...T...T...T...T...T...T...T...T...T..............................................................T.T
T...T...T...T...T...T...T...T...T...T...T...T...T...T...T...T................................................................T.T
T.T...T...T...T...T...T...T...T...T...T...T...T...T...T...T...T..............................................................T.T
T...T...T...T...T...T...T...T...T...T...T...T...T...T...T...T................................................................T.T
T.T...T...T...T...T...T...T...T...T...T...T...T...T...T...T...T..............................................................T.T
T...T...T...T...T...T...T...T...T...T...T...T...T...T...T...T................................................................T.T
T.T...T...T...T...T...T...T...T...T...T...T...T...T...T...T...T..............................................................T.T
T...T...T...T...T...T...T...T...T...T...T...T...T...T...T...T................................................................T.T
T.T...T...T...T...T...T...T...T...T...T...T...T...T...T...T...T..............................................................T.T
T...T...T...T...T...T...T...T...T...T...T...T...T...T...T...T................................................................T.T
T.T...T...T...T...T...T...T...T...T...T...T...T...T...T...T...T..............................................................T.T
T...T...T...T...T...T...T...T...T...T...T...T...T...T...T...T................................................................T.T
T.T...T...T...T...T...T...T...T...T...T...T...T...T...T...T...T..............................................................T.T
T...T...T...T...T...T...T...T...T...T...T...T...T...T...T...T................................................................T.T
T.T...T...T...T...T...T...T...T...T...T...T...T...T...T...T...T..............................................................T.T
T...T...T...T...T...T...T...T...T...T...T...T...T...T...T...T................................................................T.T
T.T...T...T...T...T...T...T...T...T...T...T...T...T...T...T...T..............................................................T.T
T...T...T...T...T...T...T...T...T...T...T...T...T...T...T...T................................................................T.T
T.T...T...T...T...T...T...T...T...T...T...T...T...T...T...T...T..............................................................T.T
T...T...T...T...T...T...T...T...T...T...T...T...T...T...T...T................................................................T.T
T.T...T...T...T...T...T...T...T...T...T...T...T...T...T...T...T..............................................................T.T
T...T...T...T...T...T...T...T...T...T...T...T...T...T...T...T................................................................T.T
T.T...T...T...T...T...T...T...T...T...T...T...T...T...T...T...T..............................................................T.T
T...T...T...T...T...T...T...T...T...T...T...T...T...T...T...T................................................................T.T
T.T...T...T...T...T...T...T...T...T...T...T...T...T...T...T...T..............................................................T.T
T...T...T...T...T...T...T...T...T...T...T...T...T...T...T...T................................................................T.T
T.T...T...T...T...T...T...T...T...T...T...T...T...T...T...T...T..............................................................T.T
T...T...T...T...T...T...T...T...T...T...T...T...T...T...T...T................................................................T.T
T.T...T...T...T...T...T...T...T...T...T...T...T...T...T...T...T..............................................................T.T
T...T...T...T...T...T...T...T...T...T...T...T...T...T...T...T................................................................T.T
T.T...T...T...T...T...T...T...T...T...T...T...T...T...T...T...T..............................................................T.T
T...T...T...T...T...T...T...T...T...T...T...T...T...T...T...T................................................................T.T
T.T...T...T...T...T...T...T...T...T...T...T...T...T...T...T...T..............................................................T.T
T...T...T...T...T...T...T...T...T...T...T...T...T...T...T...T................................................................T.T
T.T...T...T...T...T...T...T...T...T...T...T...T...T...T...T...T..............................................................T.T
T...T...T...T...T...T...T...T...T...T...T...T...T...T...T...T................................................................T.T
T.T...T...T...T...T...T...T...T...T...T...T...T...T...T...T...T..............................................................T.T
T...T...T...T...T...T...T...T...T...T...T...T...T...T...T...T................................................................T.T
T.T...T...T...T...T...T...T...T...T...T...T...T...T...T...T...T..............................................................T.T
T...T...T...T...T...T...T...T...T...T...T...T...T...T...T...T................................................................T.T
T.T...T...T...T...T...T...T...T...T...T...T...T...T...T...T...T..............................................................T.T
T...T...T...T...T...T...T...T...T...T...T...T...T...T...T...T................................................................T.T
T.T...T...T...T...T...T...T...T...T...T...T...T...T...T...T...T..............................................................T.T
T...T...T...T...T...T...T...T...T...T...T...T...T...T...T...T................................................................T.T
T.T...T...T...T...T...T...T...T...T...T...T...T...T...T...T...T..............................................................T.T
T...T...T...T...T...T...T...T...T...T...T...T...T...T...T...T................................................................T.T
T.T...T...T...T...T...T...T...T...T...T...T...T...T...T...T...T..............................................................T.T
T...T...T...T...T...T...T...T...T...T...T...T...T...T...T...T................................................................T.T
T.T...T...T...T...T...T...T...T...T...T...T...T...T...T...T...T..............................................................T.T
T...T...T...T...T...T...T...T...T...T...T...T...T...T...T...T................................................................T.T
T.T...T...T...T...T...T...T...T...T...T...T...T...T...T...T...T..............................................................T.T
T...T...T...T...T...T...T...T...T...T...T...T...T...T...T...T................................................................T.T
T.T...T...T...T...T...T...T...T...T...T...T...T...T...T...T...T..............................................................T.T
T...T...T...T...T...T...T...T...T...T...T...T...T...T...T...T................................................................T.T
T.T...T...T...T...T...T...T...T...T...T...T...T...T...T...T...T..............................................................T.T
T...T...T...T...T...T...T...T...T...T...T...T...T...T...T...T................................................................T.T
T.T...T...T...T...T...T...T...T...T...T...T...T...T...T...T...T..............................................................T.T
T...T...T...T...T...T...T...T...T...T...T...T...T...T...T...T................................................................T.T
T.T...T...T...T...T...T...T...T...T...T...T...T...T...T...T...T..............................................................T.T
T...T...T...T...T...T...T...T...T...T...T...T...T...T...T...T................................................................T.T
T.T...T...T...T...T...T...T...T...T...T...T...T...T...T...T...T..............................................................T.T
T...T...T...T...T...T...T...T...T...T...T...T...T...T...T...T................................................................T.T
T.T...T...T...T...T...T...T...T...T...T...T...T...T...T...T...T..............................................................T.T
T...T...T...T...T...T...T...T...T...T...T...T...T...T...T...T................................................................T.T
T.T...T...T...T...T...T...T...T...T...T...T...T...T...T...T...T..............................................................T.T
T...T...T...T...T...T...T...T...T...T...T...T...T...T...T...T................................................................T.T
T.T...T...T...T...T...T...T...T...T...T...T...T...T...T...T...T..............................................................T.T
T...T...T...T...T...T...T...T...T...T...T...T...T...T...T...T................................................................T.T
T.T...T...T...T...T...T...T...T...T...T...T...T...T...T...T...T..............................................................T.T
T...T...T...T...T...T...T...T...T...T...T...T...T...T...T...T................................................................T.T
T.T...T...T...T...T...T...T...T...T...T...T...T...T...T...T...T..............................................................T.T
T...T...T...T...T...T...T...T...T...T...T...T...T...T...T...T................................................................T.T
T.T...T...T...T...T...T...T...T...T...T...T...T...T...T...T...T..............................................................T.T
T...T...T...T...T...T...T...T...T...T...T...T...T...T...T...T................................................................T.T
T.T...T...T...T...T...T...T...T...T...T...T...T...T...T...T...T..............................................................T.T
T...T...T...T...T...T...T...T...T...T...T...T...T...T...T...T................................................................T.T
T.T...T...T...T...T...T...T...T...T...T...T...T...T...T...T...T..............................................................T.T
T...T...T...T...T...T...T...T...T...T...T...T...T...T...T...T................................................................T.T
T.T...T...T...T...T...T...T...T...T...T...T...T...T...T...T...T..............................................................T.T
T...T...T...T...T...T...T...T...T...T...T...T...T...T...T...T................................................................T.T
T.T...T...T...T...T...T...T...T...T...T...T...T...T...T...T...T..............................................................T.T
T...T...T...T...T...T...T...T...T...T...T...T...T...T...T...T................................................................T.T
T.T...T...T...T...T...T...T...T...T...T...T...T...T...T...T...T..............................................................T.T
T...T...T...T...T...T...T...T...T...T...T...T...T...T...T...T................................................................T.T
T.T...T...T...T...T...T...T...T...T...T...T...T...T...T...T...T..............................................................T.T
T...T...T...T...T...T...T...T...T...T...T...T...T...T...T...T................................................................T.T
T.T...T...T...T...T...T...T...T...T...T...T...T...T...T...T...T..............................................................T.T
T...T...T...T...T...T...T...T...T...T...T...T...T...T...T...T................................................................T.T
T.T...T...T...T...T...T...T...T...T...T...T...T...T...T...T...T..............................................................T.T
T...T...T...T...T...T...T...T...T...T...T...T...T...T...T...T................................................................T.T
T.T...T...T...T...T...T...T...T...T...T...T...T...T...T...T...T..............................................................T.T
T...T...T...T...T...T...T...T...T...T...T...T...T...T...T...T................................................................T.T
T.T...T...T...T...T...T...T...T...T...T...T...T...T...T...T...T..............................................................T.T
T...T...T...T...T...T...T...T...T...T...T...T...T...T...T...T................................................................T.T
T.T...T...T...T...T...T...T...T...T...T...T...T...T...T...T...T..............................................................T.T
T...T...T...T...T...T...T...T...T...T...T...T...T...T...T...T................................................................T.T
TTTTTTTTTTTTTTTTTTTTTTTTTTTTTTTTTTTTTTTTTTTTTTTTTTTTTTTTTTTTTTTTTTTTTTTTTTTTTTTTTTTTTTTTTTTTTTTTTTTTTTTTTTTTTTTTTTTTTTTTTTTTTTTT
