type octile
height 32
width 32
map
TTTTTTTTTTTTTTTTTTTTTTTTTTTTTTTT
T..............................T
T..............................T
T..T.........T.................T
T............T.................T
T....TTTTTTT.T.................T
T....T.......T.................T
T....T.T.....T.................T
T....T.......T.................T
T....T...T...T.................T
T....T.......T.................T
T....T.....T.T.................T
T............T.................T
T..TTTTTTTTTTT.................T
T..............................T
T..............................T
T..............................T
T..............................T
T..............................T
T..............................T
T..............................T
T..............................T
T..............................T
T......................TTTTTTT.T
T......................T.......T
T......................T.......T
T......................T.......T
T......................T.......T
T......................T.......T
T......................T.......T
T..............................T
TTTTTTTTTTTTTTTTTTTTTTTTTTTTTTTT
