type octile
height 12
width 12
map
TTTTTTTTTTTT
T.......T..T
T.TTT...T..T
TsTTT...T..T
T.TTT...T..T
T.TTT....t.T
T..........T
T..........T
T..........T
T..........T
T..........T
TTTTTTTTTTTT
