type octile
height 128
width 128
map
TTTTTTTTTTTTTTTTTTTTTTTTTTTTTTTTTTTTTTTTTTTTTTTTTTTTTTTTTTTTTTTTTTTTTTTTTTTTTTTTTTTTTTTTTTTTTTTTTTTTTTTTTTTTTTTTTTTTTTTTTTTTTTTT
T..............................................................................................................................T
T..............................................................................................................................T
T..............................................................................................................................T
T..............................................................................................................................T
T..............................................................................................................................T
T..............................................................................................................................T
T..............................................................................................................................T
T..............................................................................................................................T
T..............................................................................................................................T
T..............................................................................................................................T
T..............................................................................................................................T
T..............................................................................................................................T
T..............................................................................................................................T
T..............................................................................................................................T
T..............................................................................................................................T
T..............................................................................................................................T
T..............................................................................................................................T
T..............................................................................................................................T
T..............................................................................................................................T
T..............................................................................................................................T
T..............................................................................................................................T
T..............................................................................................................................T
T..............................................................................................................................T
T..............................................................................................................................T
T..............................................................................................................................T
T..............................................................................................................................T
T..............................................................................................................................T
T..............................................................................................................................T
T..............................................................................................................................T
T..............................................................................................................................T
T..............................................................................................................................T
TTT.T.T......TT....T..T...TT.T....T......TT.TT..T......T..T...T.TT............TT..TT........TT..........T..T.T...........TT.T..T
T.T.T....T.......T...T....T....T.....T....T.T......T.T......TT..........T.T..T.T.......T....T.T.......T...T...T.T...T.TT..T....T
T........T...........TT.T....T.....TT....T.TT...T.TT....T....T......T..T......TT..T.TTTT.T..TT.........T.......T...T.TT..TT.T.TT
TTT.T....T...T...T..T.....T..T.TT.T....T.......T...........T.....T.T.T...T.........T....T.T.............T.T........T.T.T...T...T
T.T.........T....T.......TT.TTT.....TT......................T..T.....T..T..T....T........TT..TT...........T.T..........T.T...TTT
T.T..T.........T................................T..T.T...T..T..........T....T..............T..T..........T...........T..T....T.T
T..T.........TTT.T......T....T...TT....T.....T.........T...T..T.......TT..TT........T....T....T....T..........TTT...T.....TT...T
T.TT.T.T...T....T......T..............T.......TT.......T.......TT........TT.TTTT.T.......T.T.T...TT....TTT..T.....T..T....T..T.T
T....................T..........T.....T.......T........T....T....T...T......TT...T..T.TT...................T..T.....T...T......T
T....T.T........T..........T......T..........T....T...T..........T.T.......T...T.T....T.T..T..T.T..T..T...T..T..T........T.....T
T........T.....................TT.......T...TT........TT..T........T...T.........TT...........T.T.....T.....T....T............TT
T.......TT...TT...T......T..........T..................T.T..T........T..T.T........T.....TTT....T....TT.......T........TT....TTT
T.......TT........T...T...T...........TT.T.....T.T...T......TT.....T.T....T.T.T...T.T....T........T..TTT...T..TT.T.T.T.T.......T
TT.....T.........T..TT..T..T....T............T.....T.....T.................................T.T.TT......T.....TT.....T.........TT
T.........T..T..TT....T...T....T.....T..T.T............T....T.T....T.....T..TT.T.T.T.T.....TT......T..TT....T..T..T....T.......T
T..T...........TT...T..............T.T.........T...........T.T......TT.T.T.T.....T.T.T.TT....T.T..TT.T......T..TTT.....TT......T
T............T..T..................TTTT...............T..TT....T.......T....TT...T..T.T........T...........TT......TT......T.T.T
T.TTTTT....T.......TTT...............TT.....TTT..........T...........TT..........T.....T...TT............T.....T............T..T
T..T...T.T.........T...........T....T...T.......TT...T.......................T.T.......T............T.T..T....T............T.T.T
T.T..........TT..................T...TTT...T....T.....T......T..T..T.....TT..T...TT...........T........T.T.....T.....T.....T.T.T
T..T...T....TT......T....T.TT......T....TT...........TT.T..........TTT.........T..T......T..T.....TT..TTT.T.......T.T..........T
T..T..T.........T..T.......T......T..TT.................T......T...T..TT..T........T.TT.....T.T....T...T.T..........T.T....T...T
T...T..T..........T.T..T..T......T....T..T.T............TT..........................T.T.......T.T..............T.T.T..T..T.TT..T
TTTT..T.......T.T....T.TTTTT...T...T.T......TT......T.T...T.............T........T.T....................T.........T............T
TT..T.T.......T...T......T...T..........T........T..T.............T....T.T.....T....TT......T...TT..T......T.T.........T.TT....T
T....T...T.T.....T.T.T..............T.TT...T..T.TT.TT...T....T...............T.....T.......T...T.T....T.T..............T...T...T
TT..........T..TT.......T.T...T......T.T.........T...T..................T........T..T.T...TTT......T.......TT............T...TTT
T....TT..T.....T...T..TT.T...T..........T...T...........T......T......T...T.T.TT......T........................TT.T...T........T
T.........T................TT..T..........T...T...T....T.....................T.T.....T.......TTTTTTT.......T......TT.T.T.T.T..TT
T....T.TT....T.TT.T.....T.....T..............TT...T.......T.........TT......T......TT.T....TT.....T..........T.T...T.T.T..T....T
T.......T.T.TT..T..............TTT....TT.T..T...T.......T........T.TTTTT..T.T.....T......T......T.T.......T..T...T.............T
T.T.T.....T...T...T.T...T.......T....TT..TT..........T.T......T..........................T..........T......T...T.TT..T.TT......T
T....T...TT...T.TTTTTTTTTTTTTTTTTTTTTTTTTTTTTTTTTTTTTTTTTTTTTTTTTTTTTTTTTTTTTTTTTTTTTTTTTTTTTTTTTTTTTTTTTTTTTTTT...T..T........T
T..T.........T..................TTT.T.TT................T.....T..T..........T.....T...T...........T...T..............TT....TT..T
T....T...TT..T....T..T..T........T...TT........T..TT...T.................T.....T..T........T...TT.....T...T...T..T.........TT..T
TTT.T..............T.TT.......T..TT.....T............TT...T......T........T..T...T...T....TT..T......T.....T...T....TTT..T.....T
T..T....T....T.............T.T.TT...T.........T.......T...TT........TT...T.T..TT....T...........T.........T.....T...TTT..T.....T
T............T......TT......T....T.....T...T.T..........T.....T.T....T...T.......T.....TT...........T......T.....TT............T
TT...TT..T...TT.......T..TT.........T..........T.T.T.....TT..T...T..T...T.TT....................T..T.........T......T......TTT.T
T.T.T..T..TT........TT.T.TTTT.T...T..............T.T...TT..T...TT.T.......T.T..T......TTT.....T...T.T......T....T...T........T.T
T.......T.....T............T..TT....T.....T.........T....TT........T.T......TT....T....T............T....T.T..................TT
TTTTT.T...............T.T.T......T............T..T.TT..T..T............T...T...TTT.....T...T.TT.T..T......T......T.T.TT..T...T.T
T......T.T.T......T............TTT...T.T.....T...T.................T.......T.....T.......................T..........T........T.T
TT..T...........T..........T..........T...T.T..............T....T..........TT.T........T..........T..........T.............T...T
TT..T...T....T...T.TT...T..T......T..TT...TT.T.......T...T.T....TT...............TT.T.........T.T.....T...............T...T....T
T........T.T...T.........T......T.T.T..T....T......T.T..T.....T....TT....T.......T.......TTT....T.....T.......T...TT..........TT
T.......T..T..T.TT.T.T.T.......T.......TT...............T....TTT..TTT.....T...T................T...T...T..T.T.T..T..T..T.......T
T..T.T..T.T.......TT..TT....T...T.T..T.....TT.........T.......................T.......T.T..............T.T......T..TT.T........T
T.......T..T..........T.......T.T........T....T...T.........TT....TT....T...........T...T........T...T....T......T.TT...T....TTT
T...........T....T.......T.T......T....T..T......T.T......T..T....................T..T.TT...........T.........T....T....T....T.T
T....T.....T.....T........T.T..T......TT...T.T.T..........T.....T..T.T...T.........T...TT.................T......T.......TTT...T
T....TT..........T...T..T.....T.T...........T....TT....TT.TT...........T......T.TT.T...T......TTT....TTT....T.......T....TT....T
TT..T.T..T..T....T..T................TT.............T.....T........T..TTT...T....TT..TT...T......T.....T...T.T.....T.....TT....T
T....T....T....T.T..T.........T..T.T................T....TTT......T.T..T......T........T........T..T....T....T.T..........T..T.T
TT....T.....T..........TTT................TT....TT.....T......T...T........T.......T....T..T....T...T...TTT......T.T..T......T.T
T..T...T....T.......T.................T....T....T.T.T.T.......T.T.....T..T....T...T....T...TT..TTT..........T..........T.......T
T..................T..T....T..............T......T...............T..T.T...T.T....T.T.T.T....T..T.......T...................T..TT
T...T...T...............T..T.T........TT...T....T.............T....T....T..T...........T.......T....T.TT....T.....T.T.T....T.T.T
T........TT.......T..T...T....T..T....T..TT.....T...............T..............T.............T.................T.T.T..T.....T..T
T..T..T.....T.......T.T.....T.T......T.T..T.....T..TT....T...T....T......T....................T.................TTT.T...TT.....T
T........T..T.........T...........T......T..T..T...........T..T.T.....TTT....T...............T.T.TTT............TT.............T
T..T..T.......T......T..T...TT....T....T.T...T...........TT.......TT.........TT........T.......T.T.........T.......T....T......T
T.T..............T...T......T......T..T...........TT.T......TT....T...T...T.T.TTT...T.........T..T..T......T..........T.......TT
T.....T.T...T.T.T..T..T.T.T.........T...TTTTT..T.....T......T.T.....T.T......T...T........T.......T...T..T...T..........T....T.T
T..............................................................................................................................T
T..............................................................................................................................T
T..............................................................................................................................T
T..............................................................................................................................T
T..............................................................................................................................T
T..............................................................................................................................T
T..............................................................................................................................T
T..............................................................................................................................T
T..............................................................................................................................T
T..............................................................................................................................T
T..............................................................................................................................T
T..............................................................................................................................T
T..............................................................................................................................T
T..............................................................................................................................T
T..............................................................................................................................T
T..............................................................................................................................T
T..............................................................................................................................T
T..............................................................................................................................T
T..............................................................................................................................T
T..............................................................................................................................T
T..............................................................................................................................T
T..............................................................................................................................T
T..............................................................................................................................T
T..............................................................................................................................T
T..............................................................................................................................T
T..............................................................................................................................T
T..............................................................................................................................T
T..............................................................................................................................T
T..............................................................................................................................T
T..............................................................................................................................T
T..............................................................................................................................T
TTTTTTTTTTTTTTTTTTTTTTTTTTTTTTTTTTTTTTTTTTTTTTTTTTTTTTTTTTTTTTTTTTTTTTTTTTTTTTTTTTTTTTTTTTTTTTTTTTTTTTTTTTTTTTTTTTTTTTTTTTTTTTTT
