type octile
height 19
width 19
map
TTTTTTTTTTTTTTTTTTT
T.................T
T.................T
T...TTTTTTTTTTT...T
T.................T
T...T..T...T..T...T
T.................T
T...T..T...T..T...T
T.................T
T.................T
T.................T
T.................T
T.................T
T.................T
T.................T
T.................T
T.................T
T.................T
TTTTTTTTTTTTTTTTTTT
