type octile
height 32
width 32
map
................................
....TTTTTTTTTTTTTTTTTTTTTTTT....
...a............................
................................
................T...............
TTTTTTTTTTTTTTTTT...............
....................T...........
................TTTTT...........
.......................T........
.......................T..T.....
....................TTTT..T.....
..........................T.....
......................TTTTT.....
................................
...........................T....
...........................T....
................................
................................
................................
................................
................................
................................
................................
................................
................................
................................
................................
................................
................................
................................
TTTTTTTTTTTTTTTTTTTTTTTTTTTTTTTT
................................
